############
#S.........#
#.##.O##.O.#
#.##..##...#
#....O...O.#
#.##..##...#
#.##.O##.O.#
#..........#
#.O......OG#
############
