##########
#..S.....#
#.######.#
#.#....#.#
#.#.##.#.#
#.#.##.#.#
#.#....#.#
#.######.#
#.......G#
##########
