##############
#S...O..#....#
#.###.#.#.##.#
#.#...#.#..#.#
#.#.###.##.#.#
#.#........#.#
#.#.###.##.#.#
#.#...#..O.#.#
#.###.#.##.#.#
#.....#....#G#
##############
